%%%%%%
%.  .%
% P  %
%    %
%.  .%
%%%%%%
